5,5,5,6,6,5,5,5,5,5,5,5,5,5,5,5,5,5,5,5,5,5,5,5,5,5,5,5,5,5,5,5,5,5,5,5,5,5,5,5,5,5,5,5,5,5,5,5,5,5,5,5,5,5,5,5,5,5,5,5,5,5,5,5,5,5,5,5,5,5,5,5,5,5,5,5,5,5,5,5,5,5,5,5,5,5,5,5,5,5,5,5,5,5,5,5,5,5,5,5,5,5,5,5,5,5,5,5,5,5,5,5,5,5,5,5,5,5,5,5,5,5,5,5,5,5,5,5,11,11,11,11,11,11,11,11,11,11,11,11,11,11,11,11,11,11,11,11,11,11,
5,5,6,6,6,6,5,5,5,5,5,5,5,5,5,5,5,5,5,5,5,5,5,5,5,5,5,5,5,5,5,5,5,5,5,5,5,5,5,5,5,5,5,5,5,5,5,5,5,5,5,5,5,5,5,5,5,5,5,5,5,5,5,5,5,5,5,5,5,5,5,5,5,5,5,5,5,5,5,5,5,5,5,5,5,5,5,5,5,5,5,5,5,5,5,5,5,5,5,5,5,5,5,5,5,5,5,5,5,5,5,5,5,5,5,5,5,5,5,5,5,5,5,5,5,5,5,5,5,5,11,11,11,11,11,11,11,11,11,11,11,11,11,11,11,11,11,11,11,11,
5,6,6,6,6,6,6,5,5,5,5,5,5,5,5,5,5,5,5,5,5,5,5,5,5,5,5,5,5,5,5,5,5,5,5,5,5,5,5,5,5,5,5,5,5,5,5,5,5,5,5,5,5,5,5,5,5,5,5,5,5,5,5,5,5,5,5,5,5,5,5,5,5,5,5,5,5,5,5,5,5,5,5,5,5,5,5,5,5,5,5,41,41,5,5,5,5,5,5,5,5,5,5,5,5,5,5,5,5,5,5,5,5,5,5,5,5,5,5,5,5,5,5,5,5,5,5,5,5,5,11,11,11,11,11,11,11,11,11,11,11,11,11,11,11,11,11,11,11,11,
5,6,6,6,6,6,6,5,5,5,5,5,5,5,5,5,5,5,5,5,5,5,5,5,5,5,5,5,5,5,5,5,5,21,28,5,5,5,5,5,5,5,5,5,5,5,5,5,5,5,5,5,5,5,5,5,5,5,5,5,5,5,5,5,5,5,5,5,5,5,5,5,5,5,5,5,5,5,5,5,5,5,5,5,5,5,5,5,5,5,41,21,41,5,5,5,5,5,5,5,5,5,5,5,5,5,5,5,5,5,5,5,5,5,5,5,5,5,5,5,5,5,5,5,5,5,5,5,4,4,11,11,11,11,11,11,11,11,11,11,11,11,11,11,11,11,11,11,11,11,
5,5,6,6,6,6,5,5,5,5,5,5,5,5,5,5,5,21,21,21,21,21,5,5,5,5,5,5,5,5,5,21,21,21,21,28,5,5,5,5,5,5,5,5,5,5,5,5,5,5,5,5,5,5,5,5,5,5,5,5,5,5,46,53,53,53,61,60,5,5,5,5,5,5,5,5,5,5,5,41,41,41,41,5,5,5,5,5,5,41,21,21,35,41,41,5,5,5,5,5,5,5,5,5,5,5,5,5,5,5,5,5,5,5,5,5,5,5,5,5,5,5,5,5,5,5,5,5,11,11,11,11,11,11,11,11,11,11,11,11,11,11,11,11,11,11,11,11,11,11,
5,5,5,6,6,5,5,5,5,5,5,5,5,5,5,5,21,21,21,21,21,21,21,21,21,5,5,5,5,5,21,21,21,21,28,35,35,5,5,5,5,5,5,5,5,5,5,5,5,5,5,5,5,5,5,5,5,5,5,5,5,46,48,48,55,62,62,62,60,5,5,5,5,5,5,5,5,5,41,21,21,21,21,41,5,5,5,5,41,21,21,21,35,21,35,62,5,5,5,5,5,5,5,5,5,5,5,5,5,5,5,5,5,5,5,5,5,5,5,5,5,5,5,5,5,5,5,5,11,11,11,11,11,11,11,11,11,11,11,11,11,11,11,11,11,11,11,11,11,11,
5,5,5,5,5,5,5,5,5,5,5,5,5,5,5,21,21,21,21,21,21,21,21,28,28,28,5,5,5,5,5,28,28,35,35,35,5,5,5,5,5,5,5,5,5,5,5,5,5,5,5,5,5,5,5,5,5,5,5,5,5,46,48,48,39,39,62,62,61,5,5,5,5,5,5,5,5,48,28,21,21,21,21,21,41,5,5,41,21,21,21,21,35,21,35,62,5,5,5,5,5,5,5,5,5,5,5,5,5,5,5,5,5,5,5,5,5,5,5,5,5,5,5,5,5,5,5,5,5,5,11,11,11,11,11,18,18,18,11,11,11,11,18,18,18,18,11,11,11,11,
22,22,22,22,5,5,5,5,5,5,5,5,5,5,21,21,21,21,21,21,21,28,28,28,35,35,5,5,5,5,5,5,5,5,5,5,5,5,5,5,5,5,5,5,5,5,5,5,5,5,5,5,5,5,5,5,5,5,5,5,5,5,53,48,55,55,62,60,5,5,5,5,5,5,5,5,5,48,28,21,21,21,21,21,21,41,41,28,21,21,21,21,35,21,35,62,5,5,5,5,5,5,5,5,5,5,5,5,5,5,5,5,5,5,5,5,5,5,5,5,5,5,5,5,5,5,5,5,5,5,11,11,11,11,11,18,4,4,18,11,11,11,4,4,18,4,11,11,11,11,
37,37,37,37,22,5,5,5,5,5,5,5,5,5,5,21,21,21,28,28,35,35,35,35,5,5,5,5,5,5,5,5,5,5,5,5,5,5,5,5,5,5,5,5,5,5,5,5,5,5,5,5,5,5,5,5,5,5,5,5,5,5,5,54,48,62,61,5,5,5,5,5,5,5,5,5,5,48,28,21,21,21,21,21,21,28,35,28,21,21,21,21,35,21,35,62,5,5,5,5,5,5,5,5,5,5,5,5,5,5,5,5,5,5,5,5,5,5,5,5,5,5,5,5,5,5,5,5,4,4,11,11,11,11,11,18,11,11,18,11,11,11,11,11,18,11,11,11,11,11,
37,39,39,37,37,22,5,5,5,5,5,5,5,5,5,5,5,28,35,5,5,5,5,5,5,5,5,5,5,5,5,5,5,5,5,5,5,5,5,5,5,5,46,46,46,53,53,60,5,5,5,5,5,5,5,5,5,5,5,5,5,5,5,47,48,55,61,5,5,5,5,5,5,5,5,5,5,48,28,21,21,21,21,21,21,28,35,28,21,21,21,21,35,21,35,62,5,5,5,5,5,5,5,5,5,5,5,5,5,5,5,5,5,5,5,5,5,5,5,5,5,5,5,5,5,5,5,5,11,11,11,11,11,11,11,18,11,11,18,11,11,11,11,11,18,11,11,11,11,11,
37,37,37,37,37,37,22,5,5,5,2,5,5,5,5,5,5,5,5,5,5,5,5,5,5,5,5,5,5,5,5,5,5,5,5,5,5,5,5,5,5,46,4,4,4,4,4,4,60,5,5,5,5,5,5,5,5,5,5,5,5,5,47,47,55,55,61,61,5,5,5,5,5,5,5,5,5,55,28,21,21,21,21,21,21,28,35,28,21,21,21,21,35,21,35,62,5,5,5,5,5,5,5,5,5,5,5,5,5,5,5,5,5,5,5,5,5,5,5,5,5,5,5,5,5,5,5,5,11,11,11,11,11,11,11,18,18,18,4,11,11,11,18,18,18,11,11,11,11,11,
38,38,38,38,38,38,14,5,5,2,2,2,5,5,5,5,5,5,22,22,22,22,29,29,29,29,5,5,5,5,5,5,5,2,5,5,5,5,5,5,46,4,4,4,4,4,4,4,4,60,5,5,5,5,5,5,5,5,5,5,5,46,48,48,55,55,62,62,61,5,5,5,5,5,5,5,5,55,35,21,21,21,21,21,21,28,35,28,21,21,21,21,35,21,35,62,5,5,5,5,5,5,5,5,5,5,5,5,5,5,5,5,5,5,5,5,5,5,5,5,5,5,5,5,5,5,5,5,5,5,11,11,11,11,11,4,4,4,11,11,11,11,4,4,4,11,11,11,11,11,
37,37,37,37,37,37,14,5,2,2,9,2,2,5,5,5,5,22,37,37,37,37,37,37,37,37,29,5,5,5,5,5,2,2,2,9,5,5,5,5,47,53,53,53,60,60,60,60,60,61,5,5,5,5,5,5,5,5,5,5,47,48,48,55,39,39,62,62,62,61,5,5,5,5,5,5,5,55,35,21,21,21,21,21,21,28,35,28,21,21,21,35,21,21,35,62,5,5,5,5,5,5,5,5,5,5,5,5,5,5,5,5,5,5,5,5,5,5,5,5,5,5,5,5,5,5,5,5,5,5,11,11,11,11,11,11,11,11,11,11,11,11,11,11,11,11,11,11,11,11,
37,39,39,37,39,37,14,2,2,9,9,9,2,9,5,5,5,22,37,37,39,39,39,39,37,37,36,5,5,5,5,2,9,9,9,9,9,5,5,5,54,4,4,4,4,4,4,4,4,61,5,5,5,5,5,5,5,5,5,47,48,48,39,55,55,55,62,39,62,62,61,5,5,5,5,5,5,55,35,21,21,21,21,21,21,28,35,28,21,21,35,21,21,21,35,62,5,5,5,5,5,5,5,5,5,5,5,5,5,5,5,5,5,5,5,5,5,5,5,5,5,5,5,5,5,5,5,5,4,4,11,11,11,11,11,11,11,11,11,11,11,11,11,11,11,11,11,11,11,11,
37,37,37,37,37,37,2,2,9,9,9,9,9,9,9,5,5,29,37,37,37,37,37,37,37,37,36,5,5,5,2,9,9,9,16,9,9,16,5,5,54,4,4,39,39,39,39,4,4,61,5,5,5,5,5,5,5,5,5,47,48,39,55,39,55,62,39,62,39,62,61,5,5,5,5,5,5,55,35,35,35,35,35,35,35,28,35,28,35,35,35,35,35,35,35,62,5,5,5,5,5,5,5,5,5,5,5,5,5,5,5,5,5,5,5,5,5,5,5,5,5,5,5,5,5,5,5,5,11,11,11,11,11,11,11,11,11,11,11,11,11,11,11,11,11,11,11,11,11,11,
31,31,31,31,31,31,2,9,9,16,9,9,9,9,9,16,5,14,38,38,38,38,38,38,38,38,14,5,5,5,9,16,9,16,16,16,16,5,5,5,61,4,4,4,4,4,4,4,4,61,5,5,5,5,5,5,5,5,5,47,48,55,39,55,62,62,62,39,62,62,61,5,5,5,5,5,5,55,55,62,62,62,62,62,62,35,35,35,62,62,62,62,62,62,62,62,5,5,5,5,5,5,5,5,5,5,5,5,5,5,5,5,5,5,5,5,5,5,5,5,5,5,5,5,5,5,5,5,11,11,11,11,11,11,11,11,11,11,11,11,11,11,11,11,11,11,11,11,11,11,
37,37,37,37,37,2,9,9,16,16,16,16,9,16,16,16,5,14,37,37,37,37,37,37,37,37,14,5,5,5,5,16,16,14,16,16,5,5,5,5,61,60,60,60,60,60,60,60,60,61,5,5,5,5,5,5,5,5,5,54,55,55,55,62,62,62,62,62,62,62,61,5,5,5,5,5,5,5,5,5,5,5,14,37,37,55,62,62,37,37,14,5,5,5,5,5,5,5,5,5,5,5,5,5,5,5,5,5,5,5,5,5,5,5,5,5,5,5,5,5,5,5,5,5,5,5,5,5,5,5,18,18,18,18,18,18,18,18,18,18,18,18,18,18,18,18,18,18,18,18,
37,44,45,37,39,37,9,16,16,16,14,16,16,16,16,5,5,7,37,39,37,44,45,37,39,37,7,5,5,5,5,5,5,7,5,5,5,5,5,5,61,11,11,11,42,43,11,11,11,61,5,5,5,5,5,5,5,5,5,5,61,62,62,62,63,64,62,62,62,61,5,5,5,5,5,5,5,5,5,5,5,5,7,37,44,45,37,44,45,37,7,5,5,5,5,5,5,5,5,5,5,5,5,5,5,5,5,5,5,5,5,5,5,5,5,5,5,5,5,5,5,5,5,5,5,5,5,5,5,5,18,34,18,18,18,34,18,18,18,34,18,18,18,34,18,18,18,34,18,18,
37,51,52,37,39,37,0,5,16,16,7,16,16,5,5,5,5,7,37,39,37,51,52,37,39,37,7,5,5,5,5,5,5,7,5,5,5,5,5,5,61,11,11,11,49,50,11,11,11,61,5,5,5,5,5,5,5,5,5,5,5,61,62,62,70,71,62,62,61,5,5,5,5,5,5,5,5,5,5,5,5,5,7,37,49,50,37,49,50,37,7,5,5,5,5,5,5,5,5,5,5,5,5,5,5,5,5,5,5,5,5,5,5,5,5,5,5,5,5,5,5,5,5,5,5,5,5,5,5,5,18,18,18,18,18,18,18,18,18,18,18,18,18,18,18,18,18,18,18,18,
37,58,59,37,37,37,0,5,5,5,0,5,5,5,5,5,5,0,37,37,37,58,59,37,37,37,0,5,5,5,5,5,5,7,5,5,5,5,5,5,61,11,11,11,56,57,11,11,11,61,5,5,5,5,5,5,5,5,5,5,5,5,61,60,77,78,60,60,5,5,5,5,5,5,5,5,5,5,5,5,5,5,0,37,56,57,37,56,57,37,0,5,5,5,5,5,5,5,5,5,5,5,5,5,5,5,5,5,5,5,5,5,5,5,5,5,5,5,5,5,5,5,5,5,5,5,5,5,5,5,18,18,18,18,18,18,18,18,18,18,18,18,18,18,18,18,18,18,18,18,
16,10,10,16,16,16,16,9,17,17,0,17,16,16,16,9,2,2,2,2,2,10,17,17,17,16,16,10,3,3,2,9,16,0,16,9,9,9,2,2,2,9,16,16,17,17,16,16,16,10,9,2,2,2,2,2,3,3,3,3,2,2,2,2,2,2,2,2,2,3,3,3,3,2,2,2,3,2,2,2,2,3,3,3,3,2,2,2,2,2,3,3,3,2,2,3,3,3,3,3,2,2,2,3,2,2,2,2,3,3,3,3,3,3,3,3,3,4,4,4,4,4,4,4,4,4,4,4,4,4,4,4,4,4,4,4,4,4,4,4,4,4,4,4,4,4,4,4,4,4,
16,3,3,9,10,10,9,10,10,17,17,17,17,16,9,9,9,2,2,2,3,3,10,17,17,16,9,3,3,3,3,2,9,16,16,9,9,2,3,2,3,10,9,16,17,17,17,17,16,9,2,2,3,2,2,2,2,3,3,3,2,2,2,2,3,2,2,2,3,3,3,3,3,2,2,2,2,2,2,2,3,3,3,3,2,2,2,2,3,2,2,3,3,3,2,2,3,3,3,2,2,2,2,2,2,3,2,3,3,3,3,3,3,3,3,3,4,4,4,4,4,4,4,4,4,4,4,4,4,4,4,4,4,4,4,4,4,4,4,4,4,4,4,4,4,4,4,4,4,4,
16,16,16,16,17,17,16,17,16,17,17,17,17,16,16,17,16,16,16,16,17,17,17,17,9,9,9,17,17,17,17,9,9,9,9,9,9,9,17,9,17,17,9,9,17,17,17,17,9,9,9,9,17,9,9,9,9,17,17,17,9,9,9,9,17,9,9,9,17,17,17,17,17,9,9,9,9,9,9,9,10,10,10,10,9,9,9,9,10,9,9,10,10,10,9,9,10,10,10,9,9,9,9,9,9,10,9,10,10,10,10,10,10,10,10,10,11,11,11,11,11,11,11,11,11,11,11,11,11,11,11,11,11,11,11,11,11,11,11,11,11,11,11,11,11,11,11,11,11,11,
11,10,11,11,11,10,11,11,11,11,11,10,11,11,11,11,10,11,11,11,10,11,11,11,11,10,10,10,11,11,11,11,11,11,10,10,11,11,11,11,11,11,11,11,10,11,11,11,10,11,11,11,11,11,10,11,11,11,10,11,11,11,10,11,11,11,11,11,11,11,10,11,11,11,11,10,11,11,11,11,11,11,11,10,10,11,11,11,11,11,10,11,11,11,10,11,11,11,11,11,11,11,11,11,11,10,11,11,11,10,10,11,11,10,11,11,11,11,11,11,11,11,10,11,11,10,11,11,11,10,11,11,11,11,11,11,11,11,11,11,11,11,11,11,11,11,11,11,11,11,
11,11,10,11,10,11,11,11,10,11,11,11,10,11,11,11,11,10,11,11,11,11,11,11,11,11,10,10,11,10,11,11,11,10,11,11,11,10,11,11,11,11,11,11,11,11,11,10,10,10,11,11,11,11,11,11,11,11,11,11,10,10,11,11,11,11,11,11,11,11,11,11,11,11,11,11,10,11,11,11,11,11,11,11,11,11,11,11,11,11,11,11,11,11,11,11,10,11,11,11,11,11,11,11,11,11,11,11,11,11,11,11,11,11,11,11,11,11,10,10,11,11,11,11,11,11,10,11,11,11,11,11,11,11,11,11,11,11,11,11,11,11,11,11,11,11,11,11,11,11,
